+------------------------|DØR|--+
|                               |
|     +------------+------------+
|     |            |            |
|     | {:^19} | {:^19} |
|     +------------+------------+
|                               |
|                               |
|     +------------+------------+
|     |            |            |
|     | {:^19} | {:^19} |
|     +------------+------------+
|     | {:^19} | {:^19} |
|     |            |            |
|     +------------+------------+
|                               |
|                               |
|     +------------+------------+
|     |            |            |
|     | {:^19} | {:^19} |
|     +------------+------------+
|     | {:^19} | {:^19} |
|     |            |            |
|     +------------+------------+
|                               |
+-------------------------------+