 +------------+------------+------------+------------+------------+
 |    125     |    126     |    127     |    128     |    129     |
 | {:^19} | {:^19} | {:^19} | {:^19} | {:^19} |
 +------------+------------+------------+------------+------------+
 | {:^19} | {:^19} | {:^19} | {:^19} | {:^19} |
 |    120     |    121     |    122     |    123     |    124     | 
 +------------+------------+------------+------------+------------+
 
 +------------+------------+------------+------------+------------+
 |    115     |    116     |    117     |    118     |    119     |
 | {:^19} | {:^19} | {:^19} | {:^19} | {:^19} |
 +------------+------------+------------+------------+------------+
 
