+-+------------+------------+------------+-------|DØR|----------+------------+------------+------------+
| |            |            |            |                      |            |            |            |
| | {:^19} | {:^19} | Diotima    |                      | {:^19} | {:^19} | {:^19} |
- +------------+------------+------------+                      +------------+------------+------------+
V                                                                                                      |
I                                                                                                      |
N                                                                                                      |
D                                                                                                      |
U                                                                                                      |
- +------------+------------+------------+------------+         +------------+------------+------------+
| | {:^19} | {:^19} | {:^19} | {:^19} |         |            |            |            |
| |            |            |            |            |         | {:^19} | {:^19} | {:^19} |
| +------------+------------+------------+------------+         +------------+------------+------------+
| |            |            |            |            |         |            |            |            |
| | {:^19} | {:^19} | {:^19} | {:^19} |         | {:^19} | {:^19} | {:^19} |
| +------------+------------+------------+------------+         +------------+------------+------------+
|                                                                                                      |
+------------------------------------------------------------------------------------------------------+