

+Sikringsskap------------------------------------------------------------------------|   DØR   |--------+
|                                                                                                       |
+------------+------------+------------+------------+------------+------------+                         |
|            |            |            |            |            |            |                         |
| %(hf-182-70)s | %(hf-183-34)s | %(hf-183-5)s | hf-183-35  | hf-183-181 | hf-183-240 |                         |
+------------+------------+------------+------------+------------+------------+                         |
| hf-183-199 | hf-182-192 | hf-183-43  | hf-182-161 | hf-183-16  | hf-183-29  |                         |
|            |            |            |            |            |            |                         |
+------------+------------+------------+------------+------------+------------+                         | 
|                                                                                                       |
+------------+------------+------------+------------+------------+------------+                         |
|            |            |            |            |            |            |                         |
| hf-182-177 | hf-182-46  | hf-183-238 | hf-182-92  | hf-182-23  | hf-182-194 |                         |
+------------+------------+------------+------------+------------+------------+                         |
| hf-182-34  | hf-182-52  | hf-182-132 | hf-183-38  | hf-182-137 | hf-183-30  |                         |
|            |            |            |            |            |            |                         |
+------------+------------+------------+------------+------------+------------+                         | 
|                                                                                                       |
+------------+------------+------------+------------+------------+------------+                         |
|            |            |            |            |            |            |                         |
| hf-182-250 | hf-182-159 | hf-182-72  | hf-182-29  | hf-182-31  | hf-182-55  |                         |
+------------+------------+------------+------------+------------+------------+            +------------+
| hf-183-8   | hf-183-94  | hf-182-98  | hf-183-249 | hf-182-176 | hf-183-190 |            | hf-183-173 |
|            |            |            |            |            |            |            |            |
+------------+------------+------------+------------+------------+------------+            +------------+ 
|                                                                                                       |
+------------+------------+------------+------------+------------+------------+------------+------------+
|            |            |            |            |            |            |            |            |
| hf-183-194 | hf-183-21  | hf-182-155 | hf-182-224 | hf-183-208 | hf-183-233 | hf-183-85  | hf-183-243 |
+------------+------------+------------+------------+------------+------------+------------+------------+
