+----------------------------------------------------------------+
|                                                                D
|                                                                Ø
|                                                                R
+------------+------------+------------+------------+            |
|            |            |            |            |            |
| {:^19} | {:^19} | {:^19} | {:^19} |            |
+------------+------------+------------+------------+            |
| {:^19} | {:^19} | {:^19} | {:^19} |            |
|            |            |            |            |            |
+------------+------------+------------+------------+            |
|                                                                |
+----------------------------------------------------------------+
