+--|  DØR  |--+Skap--------+------------+------------+------------+------------+------------+
|                          | {:^19} | {:^19} | {:^19} | {:^19} | {:^19} |
|                          |            |            |            |            |            |
|                          +------------+------------+------------+------------+------------+
|                                                                                           |
|             +------------+------------+------------+------------+------------+------------+
|             |            |            |            |            |            |            |
|             | {:^19} | {:^19} | {:^19} | {:^19} | {:^19} | {:^19} |
|             +------------+------------+------------+------------+------------+------------+
|             | {:^19} | {:^19} | {:^19} | {:^19} | {:^19} | {:^19} |
|             |            |            |            |            |            |            |
|             +------------+------------+------------+------------+------------+------------+
|                                                                                           |
|             +------------+------------+------------+------------+------------+------------+
|             |            |            |            |            |            |            |
|             | {:^19} | {:^19} | {:^19} | {:^19} | {:^19} | {:^19} |
|             +------------+------------+------------+------------+------------+------------+
|             | {:^19} | {:^19} | {:^19} | {:^19} | {:^19} | {:^19} |
|             |            |            |            |            |            |            |
|             +------------+------------+------------+------------+------------+------------+
|                                                                                           |
|             +------------+------------+------------+------------+------------+------------+
|             |            |            |            |            |            |            |
|             | {:^19} | {:^19} | {:^19} | {:^19} | {:^19} | {:^19} |
|             +------------+------------+------------+------------+------------+------------+
|             | {:^19} | {:^19} | {:^19} | {:^19} | {:^19} | {:^19} |
|             |            |            |            |            |            |            |
|             +------------+------------+------------+------------+------------+------------+
|                                                                                           |
|             +------------+------------+------------+------------+------------+------------+
|             |            |            |            |            |            |            |
|             | {:^19} | {:^19} | {:^19} | {:^19} | {:^19} | {:^19} |
|             +------------+------------+------------+------------+------------+------------+
|             | {:^19} | {:^19} | {:^19} | {:^19} | {:^19} | {:^19} |
|             |            |            |            |            |            |            |
+-------------+------------+------------+------------+------------+------------+------------+
