+------------+------------+------------+------------+------------+------------+------------+------------+
|    P1      |    P2      |    P3      |    P4      |    P5      |    P6      |    P7      |    P8      |
| {:^19} | {:^19} | {:^19} | {:^19} | {:^19} | {:^19} | {:^19} | {:^19} |
+------------+------------+------------+------------+------------+------------+------------+------------+
| {:^19} | {:^19} | {:^19} | {:^19} | {:^19} | {:^19} | {:^19} | {:^19} |
|    P16     |    P15     |    P14     |    P13     |    P12     |    P11     |    P10     |    P9      |
+------------+------------+------------+------------+------------+------------+------------+------------+

+------------+------------+------------+------------+------------+------------+------------+------------+
|    P17     |    P18     |    P19     |    P20     |    P21     |    P22     |    P23     |    P24     |
| {:^19} | {:^19} | {:^19} | {:^19} | {:^19} | {:^19} | {:^19} | {:^19} |
+------------+------------+------------+------------+------------+------------+------------+------------+
| {:^19} | {:^19} | {:^19} | {:^19} | {:^19} | {:^19} | {:^19} | {:^19} |
|    P32     |    P31     |    P30     |    P29     |    P28     |    P27     |    P26     |    P25     |
+------------+------------+------------+------------+------------+------------+------------+------------+

+------------+------------+------------+------------+------------+------------+------------+------------+
|    P33     |    P34     |    P35     |    P36     |    P37     |    P38     |    P39     |    P40     |
| {:^19} | {:^19} | {:^19} | {:^19} | {:^19} | {:^19} | {:^19} | {:^19} |
+------------+------------+------------+------------+------------+------------+------------+------------+
| {:^19} | {:^19} | {:^19} | {:^19} | {:^19} | {:^19} | {:^19} | {:^19} |
|    P48     |    P47     |    P46     |    P45     |    P44     |    P43     |    P42     |    P41     | 
+------------+------------+------------+------------+------------+------------+------------+------------+
